{
  "MAPF": "CBS",
  "SAPF": "TDSP",
  "costFunction": "SIC",
  "heuristic": "",
  "nAgents": 2,
  "nNodes": 29,
  "connect": [
    [      1,      1,      0,      0,      0,      0,      0,      0,      0,      0,      1,      0,      0,      0,      0,      0,      0,      0,      0,      0,      0,      0,      0,      0,      0,      0,      0,      0,      0    ],
    [      1,      1,      1,      0,      0,      0,      0,      0,      0,      0,      0,      0,      0,      0,      0,      0,      0,      0,      0,      0,      0,      0,      0,      0,      0,      0,      0,      0,      0    ],
    [      0,      1,      1,      1,      0,      0,      0,      0,      0,      0,      0,      0,      0,      0,      0,      0,      0,      0,      0,      0,      0,      0,      0,      0,      0,      0,      0,      0,      0    ],
    [      0,      0,      1,      1,      1,      0,      0,      0,      0,      0,      0,      0,      0,      0,      0,      0,      0,      0,      0,      0,      0,      0,      0,      0,      0,      0,      0,      0,      0    ],
    [      0,      0,      0,      1,      1,      1,      0,      0,      0,      0,      0,      0,      0,      0,      0,      0,      0,      0,      0,      0,      0,      0,      0,      0,      0,      0,      0,      0,      0    ],
    [      0,      0,      0,      0,      1,      1,      1,      0,      0,      0,      0,      0,      0,      0,      0,      0,      0,      0,      0,      0,      0,      0,      0,      0,      0,      0,      0,      0,      0    ],
    [      0,      0,      0,      0,      0,      1,      1,      1,      0,      0,      0,      0,      0,      0,      0,      0,      0,      0,      0,      0,      0,      0,      0,      0,      0,      0,      0,      0,      0    ],
    [      0,      0,      0,      0,      0,      0,      1,      1,      1,      0,      0,      0,      0,      0,      0,      0,      0,      0,      0,      0,      0,      0,      0,      0,      0,      0,      0,      0,      0    ],
    [      0,      0,      0,      0,      0,      0,      0,      1,      1,      10,      0,      0,      0,      0,      0,      0,      0,      0,      0,      0,      0,      0,      0,      0,      0,      0,      0,      0,      0    ],
    [      0,      0,      0,      0,      0,      0,      0,      0,      10,      1,      0,      0,      0,      0,      0,      0,      0,      0,      0,      1,      0,      0,      0,      0,      0,      0,      0,      0,      0    ],
    [      1,      0,      0,      0,      0,      0,      0,      0,      0,      0,      1,      1,      0,      0,      0,      0,      0,      0,      0,      0,      1,      0,      0,      0,      0,      0,      0,      0,      0    ],
    [      0,      0,      0,      0,      0,      0,      0,      0,      0,      0,      1,      1,      1,      0,      0,      0,      0,      0,      0,      0,      0,      0,      0,      0,      0,      0,      0,      0,      0    ],
    [      0,      0,      0,      0,      0,      0,      0,      0,      0,      0,      0,      1,      1,      1,      0,      0,      0,      0,      0,      0,      0,      0,      0,      0,      0,      0,      0,      0,      0    ],
    [      0,      0,      0,      0,      0,      0,      0,      0,      0,      0,      0,      0,      1,      1,      1,      0,      0,      0,      0,      0,      0,      0,      0,      0,      0,      0,      0,      0,      0    ],
    [      0,      0,      0,      0,      0,      0,      0,      0,      0,      0,      0,      0,      0,      1,      1,      1,      0,      0,      0,      0,      0,      0,      0,      0,      0,      0,      0,      0,      0    ],
    [      0,      0,      0,      0,      0,      0,      0,      0,      0,      0,      0,      0,      0,      0,      1,      1,      1,      0,      0,      0,      0,      0,      0,      0,      0,      0,      0,      0,      0    ],
    [      0,      0,      0,      0,      0,      0,      0,      0,      0,      0,      0,      0,      0,      0,      0,      1,      1,      1,      0,      0,      0,      0,      0,      0,      0,      0,      0,      0,      0    ],
    [      0,      0,      0,      0,      0,      0,      0,      0,      0,      0,      0,      0,      0,      0,      0,      0,      1,      1,      1,      0,      0,      0,      0,      0,      0,      0,      0,      0,      0    ],
    [      0,      0,      0,      0,      0,      0,      0,      0,      0,      0,      0,      0,      0,      0,      0,      0,      0,      1,      1,      10,      0,      0,      0,      0,      0,      0,      0,      0,      0    ],
    [      0,      0,      0,      0,      0,      0,      0,      0,      0,      1,      0,      0,      0,      0,      0,      0,      0,      0,      10,      1,      0,      0,      0,      0,      0,      0,      0,      0,      0    ],
    [      0,      0,      0,      0,      0,      0,      0,      0,      0,      0,      1,      0,      0,      0,      0,      0,      0,      0,      0,      0,      1,      1,      0,      0,      0,      0,      0,      0,      0    ],
    [      0,      0,      0,      0,      0,      0,      0,      0,      0,      0,      0,      0,      0,      0,      0,      0,      0,      0,      0,      0,      1,      1,      1,      0,      0,      0,      0,      0,      0    ],
    [      0,      0,      0,      0,      0,      0,      0,      0,      0,      0,      0,      0,      0,      0,      0,      0,      0,      0,      0,      0,      0,      1,      1,      1,      0,      0,      0,      0,      0    ],
    [      0,      0,      0,      0,      0,      0,      0,      0,      0,      0,      0,      0,      0,      0,      0,      0,      0,      0,      0,      0,      0,      0,      1,      1,      1,      0,      0,      0,      0    ],
    [      0,      0,      0,      0,      0,      0,      0,      0,      0,      0,      0,      0,      0,      0,      0,      0,      0,      0,      0,      0,      0,      0,      0,      1,      1,      1,      0,      0,      0    ],
    [      0,      0,      0,      0,      0,      0,      0,      0,      0,      0,      0,      0,      0,      0,      0,      0,      0,      0,      0,      0,      0,      0,      0,      0,      1,      1,      1,      0,      0    ],
    [      0,      0,      0,      0,      0,      0,      0,      0,      0,      0,      0,      0,      0,      0,      0,      0,      0,      0,      0,      0,      0,      0,      0,      0,      0,      1,      1,      1,      0    ],
    [      0,      0,      0,      0,      0,      0,      0,      0,      0,      0,      0,      0,      0,      0,      0,      0,      0,      0,      0,      0,      0,      0,      0,      0,      0,      0,      1,      1,      1    ],
    [      0,      0,      0,      0,      0,      0,      0,      0,      0,      0,      0,      0,      0,      0,      0,      0,      0,      0,      0,      0,      0,      0,      0,      0,      0,      0,      0,      1,      1    ]
  ],
  "nodes": [
    [      2113,      0,      21,      13    ],
    [      2114,      1,      21,      14    ],
    [      2115,      2,      21,      15    ],
    [      2116,      3,      21,      16    ],
    [      2117,      4,      21,      17    ],
    [      2118,      5,      21,      18    ],
    [      2119,      6,      21,      19    ],
    [      2120,      7,      21,      20    ],
    [      2121,      8,      21,      21    ],
    [      2122,      9,      21,      22    ],
    [      2213,      10,      22,      13    ],
    [      2214,      11,      22,      14    ],
    [      2215,      12,      22,      15    ],
    [      2216,      13,      22,      16    ],
    [      2217,      14,      22,      17    ],
    [      2218,      15,      22,      18    ],
    [      2219,      16,      22,      19    ],
    [      2220,      17,      22,      20    ],
    [      2221,      18,      22,      21    ],
    [      2222,      19,      22,      22    ],
    [      2313,      20,      23,      13    ],
    [      2314,      21,      23,      14    ],
    [      2315,      22,      23,      15    ],
    [      2316,      23,      23,      16    ],
    [      2317,      24,      23,      17    ],
    [      2318,      25,      23,      18    ],
    [      2319,      26,      23,      19    ],
    [      2320,      27,      23,      20    ],
    [      2321,      28,      23,      21    ]
  ],
  "agents": [    {
      "ID": 0,
      "initPos": [        2321,        28,        23,        21      ],
      "endPos": [        2317,        24,        23,        17      ],
      "goalPos": [
        [          2220,          17,          22,          20        ],
        [          2117,          4,          21,          17        ],
        [          2213,          10,          22,          13        ],
        [          2117,          4,          21,          17        ],
        [          2214,          11,          22,          14        ]
      ]
    },
    {
      "ID": 1,
      "initPos": [        2222,        19,        22,        22      ],
      "endPos": [        2218,        15,        22,        18      ],
      "goalPos": [
        [          2117,          4,          21,          17        ],
        [          2313,          20,          23,          13        ],
        [          2119,          6,          21,          19        ],
        [          2120,          7,          21,          20        ],
        [          2320,          27,          23,          20        ]
      ]
    }
  ]
}